21
TTTTTTTTTTTTTTTTTTTTT
TTTTTTTTTTTTTTTTTTTTT
TTTTTTTTTTTTTTTTTTTTT
TTTTTTTTTTTTTTTTTTTTT
TTTTMMMMMMMMMTTTTTTTT
TTTMMVVVMMVVMMMMMMTTT
TMMMVVVVVMVVMVVVVMMMT
TMVVVVMVVMVVMVVEEEVMT
TMVMVVMVVMMVMVMEMEVMT
TMVVMVMVVVMVVVVEVEVMT
TMVVVVVVVVMVMVMEMEVMT
TMVVVMMVVMMVVVVEVEVMT
TMVVVMVVVMVVMVMEMEVMT
TMMVVVVVVVVVVVVEEEVMT
TTMVVMMMMMMVVVVMMVVMT
TTMVVMTTTTMMMMMMMMMMT
TTMMMMTTTTTTTTTTTTTTT
TTTTTTTTTTTTTTTTTTTTT
TTTTTTTTTTTTTTTTTTTTT
TTTTTTTTTTTTTTTTTTTTT
TTTTTTTTTTTTTTTTTTTTT

1
17,13

16
3,10
3,12
3,14
4,13
5,7
5,9
6,6
6,10
7,11
8,8
15,7
15,8
15,10
15,12
16,7
17,7