9
TTMMMMMTT
MMMVVVMTT
MEVVVVMTT
MMMVVEMTT
MEMMVVMTT
MVMVEVMMT
MVVEVVEMT
MVVVEVVMT
MMMMMMMMT

1
2,2

7
3,2
4,3
4,4
1,6
3,6
4,6
5,6